NAME	OS
Abdirahman Owens	MacOS
Abdul Armitage	MacOS
Annette Leblanc	Windows 10
Arham Cash	MacOS
Arwel Amin	MacOS
Billie Corrigan	Windows 10
Carla Chavez	Windows 10
Cinar Fleming	Windows 10
Emma Bonilla	Windows 10
Evie-Grace Short	Windows 10
Farzana Gallegos	MacOS
Fraser Case	MacOS
Garin Hunt	Windows 10
Gregg Stephens	MacOS
Jenna Salt	Windows 10
Joanna Santos	Windows 10
Jolene Broadhurst	MacOS
Karson Barron	MacOS
Kayleigh Cantu	Windows 10
Kinga Li	Windows 10
Lawrence Cain	MacOS
Lilian Ross	MacOS
Melina Frye	Windows 10
Miley Harper	MacOS
Neel Blackmore	MacOS
Olivia Bauer	MacOS
Olivia-Mae Frey	Windows 10
Pierre Squires	MacOS
Rhiannon Kerr	Windows 10
Rivka Dudley	Windows 10
Rosalie Burch	MacOS
Saad Tierney	MacOS
Sam Franklin	MacOS
Sami Hodges	MacOS
Sebastian Foley	Windows 10
Sia Major	Windows 10
Teigan England	MacOS
Tyler Sheridan	Windows 10
Valentina Cortez	Windows 10
Vivien Schwartz	MacOS
